NO pila
SO SUL
WE OESTE
EA ESTE
S  YES
F 220,100,0
C 225,30,0
11111111
1N000000111
10000001
10000001
11111111
11
11

