NO NORTE
SO SUL
WE OESTE
EA ESTE
S  YES
F 220,100,0
C 225,30,0



111111111
1N0000001111
100000011
10000001
11111111
11111
1



