NO pila
SO SUL
WE OESTE
EA ESTE
S  YES

11111111
1N000001
10000001
10000001
11111111